6 7
#######
#R....#
#..@..#
###a###
###O###
#######
