5 8
########
#.....O#
#Raaa.O#
#.....O#
########
