7 10
##########
#.....OO##
#..R#.OO.#
#####.#..#
#.a.a.aa.#
#........#
##########
